||||||||||||||||||||||||
|         $  $    #    |
| d   d        |x||    |
|   ||||  $   d|  | T  |
|   1 X|d    d |  |    |
|   |||| d$ d  |  |    |
|  $  $    d   | #|  E |
||||||||||||||||||||||||
I3
3<+