||||||||||||||||||||||||||||||||||||||||
| E        x          1      d         |
|    | ||| x            d  e           |
| #  |     x1      d      1         X  |
||||||||||||||||||||||||||||||||||||||||
II
2=+2==3<+2<+