||||||||||||||||||||||||||||||||||||||||
| E     #  x      x              1     |
|    | ||| x     1x                    |
| #  |     x1     x         1       X  |
||||||||||||||||||||||||||||||||||||||||