||||||||||||||||||||||||
|                 #    |
|     T        |x||    |
|   ||||       |  | T  |
|   1 X|       |  |    |
|   ||||       |  |    |
|   T  T       | #|  E |
||||||||||||||||||||||||
I3
2<F