||||||||||||||||||||||||
|                 #    |
|     T        |x||    |
|   ||||       |  |    |
|   1 X|       |  |    |
|   ||||       |  |    |
|   T  T       | #|  E |
||||||||||||||||||||||||
IM
2<F