||||||||||||
| E        |
| x x x x  |
|      ss  |
|  x x xsx |
|sssss  ss |
|sx xsx xsx|
|sss S SssX|
||||||||||||
II
K<2