||||||||||||||||||||||||||||||||||||||||
| E       Sx          1      d         |
|    | |||sx            d  e           |
| #  |    sx1      d      1     #   X  |
||||||||||||||||||||||||||||||||||||||||
IG
2=F2==3<+