||||||||||||||||||||||||
|                 #    |
|              ||||    |
|   ||||       |  | T  |
|   1 X|       |  |    |
|   ||||       |  |    |
|              |  |  E |
||||||||||||||||||||||||