||||||||||||||||||||||||||||||||||||||||
|      E                               |
|              #           1           |
| 1                                    |
| ||                               X   |
||||||||||||||||||||||||||||||||||||||||