||||||||||||||||||||||||||||||||||||||||
| E        x          1      d         |
|    | ||| x            d  e           |
| #  |     x1      d      1     #   X  |
||||||||||||||||||||||||||||||||||||||||
IG
2=F2==3<+